
components:

Customer Module:
1.signIn:                   registration                         -public R
2.login:                    already registered                   -public R
3.Store:                    categorywise product list            -public
4.product Details:          product details by id                -public
5.update:                   Update product quantity              -public

OrderModule:
1.Order:                    show particular customer order       -public
2.OrderDetails:             show orderdetails                    -public
3.OrderHistory:             show the orderhistory                -public
4.ShowAllOrders             Order List                           -private R
5.Order                     Details of Particular Order          -private R          

1.Home:                     list of products                     -public
2.Profile                   details of Customer                  -public R
3.Privacy:                  customer care                        -public R
4.Routing                   Routing                              -public 
 
cart Module:
1.AddToCart:                Add product in shopping cart         -public
2.MyCart:                   show product list                    -public

Employee Module:
1.Customers:                Customer list                        -private R
2.customer:                 details by id                        -private R
3.insert:                   Add new product                      -private R
4.Delete:                   Delete Existing Product              -private R
5.Update:                   Update Existing Product              -private R
6.DeleteCustomer            Delete Existing Customer             -private R

Consulting Module:
1.question:                 question list                          -public
2.Details:                  question details by id                 -public
3.AddQuestion:              Add question in my question list       -public
4.MyQuestion:               Show my question list                  -public
5.NewQuestion:              Add new question                       -public
6.QuestionCategory:         categorywise product list              -public
7.QuestionAnswer:           Show all answer of particular questionid-public
8.SubjectMatterExperts:     SME List                               -private R

Payment Module:         
1.orderpayment:             select payment mode                     -public
2.Debit Card:               trasfer payment through debit card      -public
3.Credit Card               trasfer payment through credit card     -public R
4.cash payment              
5.UPI Payment

Admin Module:
1.Employees:                Employee list                           -private R
2.Employee:                 details                                 -private R
3.NewEmployee:              Add new Employee                        -private R
4.Update:                   Update Existing Employee                -private R
5.Delete:                   Delete Existing Employee                -private R
7.Insert                    Add new SME                             -private R
8.Update                    Update Existing SME                     -private R
9.Delete                    Delete Existing SME                     -private R